鎞	𫔇
轗	𫐘
殢	𣨼
𣨼	殢
誴	𫟡
蹻	𫏋
駝	驼
圞	𪢮
爇	𦶟
𦶟	爇
鰕	𫚥
剾	𠛅
竚	𥩟
騃	𫘤
鶒	𫛶
駞	𫘞
𫘞	驼
唓	𪠳
囃	𠱞
嗹	𪡏
饠	𫗩
壈	𡒄
蹔	𫏐
餔	𫗦
熌	𤇄
屩	𪨗
憸	𪫺
摐	𪭢
鵩	𫛳
鶗	𫛸
煇	𪸩
玁	𤞤
鳷	𫛛
痮	𪽪
軿	𫐌
篘	𥬠
矑	𪾦
䁪	𥇢
糺	𫄙
覼	𫌨
絁	𫄟
絍	𫟃
羵	𫅗
譊	𫍢
䟃	𫎺
躘	𨀁
軕	𫐅
軗	𨐅
錂	𨱋
𨰃	𫔉
䦘	𨸄
鞾	𫖇
騟	𩨈
鯆	𫚙